Agile principles - принципы гибкой разработки
Area Product Owner - Владелец Области Продукта
Area Product Backlog - Бэклог Области Продукта
Backlog - Бэклог
Causal loop diagrams - Диаграммы причинного цикла
Causal relation - причинно-следственная связь
Complexity of static [details] - статическая сложность
Complexity of dynamics - динамическая сложность
Control theory - теория управления
Cross-team - кросскомандная
Development Team - Команда Разработки
Diagram of effect - диаграмма воздействия
Dynamic system models - динамические модели систем
Empirical process control - Эмпирический контроль процесса
Feature-team - продуктовая команда
Feature velocity - скорость разработки фичи
Feedback loop - цикл обратной связи
Flow diagrams - диаграммы потока
Framework - каркас
Guides - Руководства
Framework - каркас
Inspect and Adapt - Инспекция и Адаптация
Large-Scale Scrum - Масштабный Скрам
Large-scale adoption of *smth* - внедрение *smth* в больших масштабах
Large-scale *smth* adoption -внедрение *smth* в больших масштабах
Lean thinking - бережливое мышление
LeSS Overall Retrospective - всеобщая ретроспектива LeSS
Mental model - ментальная модель
Measurement dysfunction - дисфункция измерения
Morale - боевой дух
Multi-team - Многокомандный
Multi-team Product Backlog Refinement - Многокомандное Уточнение Бэклога Продукта
Overall Retrospective - Общая Ретроспектива
Overall Product Backlog Refinement - Общее Уточнение Бэклога Продукта 
Queueing Theory - Теория массового обслуживания
Perfection goal - Цель совершенства
Product Backlog - Бэклог Продукта
Product Backlog item - Элемент Бэклога Продукта
Rate of delivery - стоимость доставки
Requirement Area - Область Требований
Scrum - Скрам
Scrum Master - Скрам-мастер
Scrum Team - Скрам-команда
Sprint Planning One - Первая Часть Планирования Спринта
Sprint Planning Two - Вторая Часть Планирования Спринта
System dynamics - системная динамика
Systems thinking - системное мышление
Team-level Product Backlog Refinement - Командное Уточнение Бэклога продукта
Value - ценность
Wokrshop - сессия совместной работы
